#LEVELS 10
1. 2 3, 0, 1 2 3
2. 2 4, 0, 1 2 3
3. 3 4, 0, 1 2 3
4. 2 3, 0, 1 2 3
5. 2 4, 0, 1 2 3
6. 3 4, 0, 1 2 3
7. 2 3, 0, 1 2 3
8. 2 4, 0, 1 2 3
9. 3 4, 0, 1 2 3
10. 2 3, 0, 1 2 3